2
10
10
89 89 89 89 89 89 89 89 89 89
89 89 89 89 89 89 89 89 89 89
89 89 89 89 89 89 89 89 89 89
89 89 89 89 89 89 89 89 89 89
89 89 89 89 89 89 89 89 89 89
89 89 89 89 89 89 89 89 89 89
89 89 89 89 89 89 89 89 89 89
89 89 89 89 89 89 89 89 89 89
89 89 89 89 89 89 89 89 89 89
89 89 89 89 89 89 89 89 89 89
-1 -1 -1 -1 -1 -1 -1 -1 -1 -1
-1 -1 -1 -1 16 -1 -1 -1 -1 -1
-1 16 -1 -1 24 -1 -1 -1 -1 -1
-1 24 -1 -1 32 -1 -1 -1 -1 -1
-1 32 -1 -1 40 -1 -1 -1 -1 -1
-1 40 -1 -1 -1 -1 -1 -1 -1 -1
-1 -1 -1 -1 -1 -1 20 -1 -1 -1
-1 -1 -1 -1 -1 -1 -1 -1 -1 -1
-1 -1 -1 -1 -1 -1 -1 -1 -1 -1
-1 -1 -1 -1 -1 -1 -1 -1 -1 -1
