1
80
80
221 222 223 17 220 221 222 223 17 220 221 222 223 17 220 221 222 223 17 220 221 222 223 17 220 221 222 223 17 220 221 222 223 17 220 221 222 223 17 220 221 222 223 17 220 221 222 223 17 220 221 222 223 17 220 221 222 223 17 220 221 222 223 17 220 221 222 223 17 220 221 222 223 17 220 221 222 223 17 17 
229 230 231 17 228 229 230 231 17 228 229 230 231 17 228 229 230 231 17 228 229 230 231 17 228 229 230 231 17 228 229 230 231 17 228 229 230 231 17 228 229 230 231 17 228 229 230 231 17 228 229 230 231 17 228 229 230 231 17 228 229 230 231 17 228 229 230 231 17 228 229 230 231 17 228 229 230 231 17 17 
237 238 239 17 236 237 238 239 17 236 237 238 239 17 236 237 238 239 17 236 237 238 239 17 236 237 238 239 17 236 237 238 239 17 236 237 238 239 17 236 237 238 239 17 236 237 238 239 17 236 237 238 239 17 236 237 238 239 17 236 237 238 239 17 236 237 238 239 17 236 237 238 239 17 236 237 238 239 17 17 
17 196 197 198 199 17 196 197 198 199 17 196 197 198 199 17 196 197 198 199 17 196 197 198 199 17 196 197 198 199 17 196 197 198 199 17 196 197 198 199 17 196 197 198 199 17 196 197 198 199 17 196 197 198 199 17 196 197 198 199 17 196 197 198 199 17 196 197 198 199 17 196 197 198 199 17 196 197 198 199 
17 204 205 206 207 17 204 205 206 207 17 204 205 206 207 17 204 205 206 207 17 204 205 206 207 17 204 205 206 207 17 204 205 206 207 17 204 205 206 207 17 204 205 206 207 17 204 205 206 207 17 204 205 206 207 17 204 205 206 207 17 204 205 206 207 17 204 205 206 207 17 204 205 206 207 17 204 205 206 207 
17 212 213 214 215 17 212 213 214 215 17 212 213 214 215 17 212 213 214 215 17 212 213 214 215 17 212 213 214 215 17 212 213 214 215 17 212 213 214 215 17 212 213 214 215 17 212 213 214 215 17 212 213 214 215 17 212 213 214 215 17 212 213 214 215 17 212 213 214 215 17 212 213 214 215 17 212 213 214 215 
17 220 221 222 223 17 220 221 222 223 17 220 221 222 223 17 220 221 222 223 17 220 221 222 223 17 220 221 222 223 17 220 221 222 223 17 220 221 222 223 17 220 221 222 223 17 220 221 222 223 17 220 221 222 223 17 220 221 222 223 17 220 221 222 223 17 220 221 222 223 17 220 221 222 223 17 220 221 222 223 
17 228 229 230 231 17 228 229 230 231 17 228 229 230 231 17 228 229 230 231 17 228 229 230 231 17 228 229 230 231 17 228 229 230 231 17 228 229 230 231 17 228 229 230 231 17 228 229 230 231 17 228 229 230 231 17 228 229 230 231 17 228 229 230 231 17 228 229 230 231 17 228 229 230 231 17 228 229 230 231 
17 236 237 238 239 17 236 237 238 239 17 236 237 238 239 17 236 237 238 239 17 236 237 238 239 17 236 237 238 239 17 236 237 238 239 17 236 237 238 239 17 236 237 238 239 17 236 237 238 239 17 236 237 238 239 17 236 237 238 239 17 236 237 238 239 17 236 237 238 239 17 236 237 238 239 17 236 237 238 239 
197 198 199 17 196 197 198 199 17 196 197 198 199 17 196 197 198 199 17 196 197 198 199 17 196 197 198 199 17 196 197 198 199 17 196 197 198 199 17 196 197 198 199 17 196 197 198 199 17 196 197 198 199 17 196 197 198 199 17 196 197 198 199 17 196 197 198 199 17 196 197 198 199 17 196 197 198 199 17 196 
205 206 207 17 204 205 206 207 17 204 205 206 207 17 204 205 206 207 17 204 205 206 207 17 204 205 206 207 17 204 205 206 207 17 204 205 206 207 17 204 205 206 207 17 204 205 206 207 17 204 205 206 207 17 204 205 206 207 17 204 205 206 207 17 204 205 206 207 17 204 205 206 207 17 204 205 206 207 17 204 
213 214 215 17 212 213 214 215 17 212 213 214 215 17 212 213 214 215 17 212 213 214 215 17 212 213 214 215 17 212 213 214 215 17 212 213 214 215 17 212 213 214 215 17 212 213 214 215 17 212 213 214 215 17 212 213 214 215 17 212 213 214 215 17 212 213 214 215 17 212 213 214 215 17 212 213 214 215 17 212 
221 222 223 17 220 221 222 223 17 220 221 222 223 17 220 221 222 223 17 220 221 222 223 17 220 221 222 223 17 220 221 222 223 17 220 221 222 223 17 220 221 222 223 17 220 221 222 223 17 220 221 222 223 17 220 221 222 223 17 220 221 222 223 17 220 221 222 223 17 220 221 222 223 17 220 221 222 223 17 220 
229 230 231 17 228 229 230 231 17 228 229 230 231 17 228 229 230 231 17 228 229 230 231 17 228 229 230 231 17 228 229 230 231 17 228 229 230 231 17 228 229 230 231 17 228 229 230 231 17 228 229 230 231 17 228 229 230 231 17 228 229 230 231 17 228 229 230 231 17 228 229 230 231 17 228 229 230 231 17 228 
237 238 239 17 236 237 238 239 17 236 237 238 239 17 236 237 238 239 17 236 237 238 239 17 236 237 238 239 17 236 237 238 239 17 236 237 238 239 17 236 237 238 239 17 236 237 238 239 17 236 237 238 239 17 236 237 238 239 17 236 237 238 239 17 236 237 238 239 17 236 237 238 239 17 236 237 238 239 17 236 
17 196 197 198 199 17 196 197 198 199 17 196 197 198 199 17 196 197 198 199 17 196 197 198 199 17 196 197 198 199 17 196 197 198 199 17 196 197 198 199 17 196 197 198 199 17 196 197 198 199 17 196 197 198 199 17 196 197 198 199 17 196 197 198 199 17 196 197 198 199 17 196 197 198 199 17 196 197 198 199 
17 204 205 206 207 17 204 205 206 207 17 204 205 206 207 17 204 205 206 207 17 204 205 206 207 17 204 205 206 207 17 204 205 206 207 17 204 205 206 207 17 204 205 206 207 17 204 205 206 207 17 204 205 206 207 17 204 205 206 207 17 204 205 206 207 17 204 205 206 207 17 204 205 206 207 17 204 205 206 207 
17 212 213 214 215 17 212 213 214 215 17 212 213 214 215 17 212 213 214 215 17 212 213 214 215 17 212 213 214 215 17 212 213 214 215 17 212 213 214 215 17 212 213 214 215 17 212 213 214 215 17 212 213 214 215 17 212 213 214 215 17 212 213 214 215 17 212 213 214 215 17 212 213 214 215 17 212 213 214 215 
288 288 288 288 288 288 288 288 288 288 288 288 288 288 288 288 288 288 288 288 288 288 288 288 288 288 288 288 288 288 288 288 288 288 288 288 288 288 288 288 288 288 288 288 288 288 288 288 288 288 288 288 288 288 288 288 288 288 288 288 288 288 288 288 288 288 288 288 288 288 288 288 288 288 288 288 288 288 288 288 
288 288 288 288 288 288 288 288 288 288 288 288 288 288 288 288 288 288 288 288 288 288 288 288 288 288 288 288 288 288 288 288 288 288 288 288 288 288 288 288 288 288 288 288 288 288 288 288 288 288 288 288 288 288 288 288 288 288 288 288 288 288 288 288 288 288 288 288 288 288 288 288 288 288 288 288 288 288 288 288 
288 288 288 288 288 288 288 288 288 288 288 288 288 288 288 288 288 288 288 288 288 288 288 288 288 288 288 288 288 288 288 288 288 288 288 288 288 288 288 288 288 288 288 288 288 288 288 288 288 288 288 288 288 288 288 288 288 288 288 288 288 288 288 288 288 288 288 288 288 288 288 288 288 288 288 288 288 288 288 288 
17 17 17 17 17 17 17 17 17 17 17 17 17 17 17 17 17 17 17 17 17 17 17 17 17 17 17 17 17 17 17 17 17 17 17 17 17 17 17 17 17 17 17 17 17 17 17 17 17 17 17 17 17 17 17 17 17 17 17 17 17 17 17 17 17 17 17 17 17 17 17 17 17 17 17 17 17 17 17 17 
17 17 17 17 17 17 17 17 17 17 17 17 17 17 17 17 17 17 17 17 17 432 433 434 435 436 437 438 439 496 497 17 17 17 17 17 17 17 17 17 17 17 17 17 17 17 17 560 561 562 563 564 565 566 567 502 503 17 17 17 17 17 17 17 17 17 17 17 17 17 17 17 17 17 17 17 17 17 17 17 
17 17 17 17 17 17 17 17 17 17 17 17 17 17 17 17 17 17 17 17 17 440 441 442 443 444 445 446 447 504 505 17 17 17 17 17 17 17 17 17 17 17 17 17 17 17 17 568 569 570 571 572 573 574 575 510 511 17 17 17 17 17 17 17 17 17 17 17 17 17 17 17 17 17 17 17 17 17 17 17 
17 17 17 17 17 17 17 17 17 17 17 17 17 17 17 17 17 17 17 17 17 448 449 450 451 452 453 454 455 512 513 17 17 17 17 16 17 17 17 17 17 17 17 17 17 17 17 576 577 578 579 580 581 582 583 518 519 17 17 17 17 17 17 17 17 17 17 17 17 17 17 17 17 17 17 17 17 17 17 17 
17 17 17 17 17 17 17 17 17 17 17 196 197 198 199 17 17 17 17 17 17 456 457 458 459 460 461 462 463 520 521 17 17 17 17 24 17 232 233 234 235 17 17 17 17 162 17 584 585 586 587 588 589 590 591 526 527 17 17 17 17 17 17 17 196 197 198 199 17 17 17 17 17 17 17 17 17 17 17 17 
17 17 17 17 17 17 17 196 197 198 199 204 205 206 207 17 17 17 17 17 17 464 465 466 467 468 469 470 471 528 529 17 162 17 17 32 17 240 241 242 243 17 406 406 17 17 17 592 593 594 595 596 597 598 599 534 535 17 17 17 17 17 17 17 204 205 206 207 196 197 198 199 17 17 17 17 17 17 17 17 
17 17 17 196 197 198 199 204 205 206 207 212 213 214 215 17 17 17 17 16 17 472 473 474 475 476 477 478 479 536 537 17 17 17 17 40 17 248 249 250 251 17 414 414 17 16 17 600 601 602 603 604 605 606 607 542 543 17 17 17 17 17 17 17 212 213 214 215 204 205 206 207 196 197 198 199 17 17 17 17 
17 17 17 204 205 206 207 212 213 214 215 220 221 222 223 17 17 17 17 24 17 480 481 482 483 484 485 486 487 544 545 17 17 17 162 17 17 17 17 17 17 162 17 163 17 24 17 608 609 610 611 612 613 614 615 550 551 17 17 17 17 17 17 17 220 221 222 223 212 213 214 215 204 205 206 207 17 17 17 17 
17 17 17 212 213 214 215 220 221 222 223 228 229 230 231 17 17 17 17 32 17 488 489 490 491 492 493 494 495 552 553 17 406 17 17 17 17 17 162 17 17 17 17 17 17 32 17 616 617 618 619 620 621 622 623 558 559 17 406 17 17 17 17 17 228 229 230 231 220 221 222 223 212 213 214 215 17 17 17 17 
17 17 17 220 221 222 223 228 229 230 231 236 237 238 239 17 17 17 17 40 17 17 17 17 17 88 90 17 17 17 17 17 414 17 17 157 17 17 17 17 17 17 17 17 17 40 17 17 17 17 17 88 90 17 17 17 17 17 414 17 17 17 17 17 236 237 238 239 228 229 230 231 220 221 222 223 17 17 17 17 
17 17 17 228 229 230 231 236 237 238 239 17 17 17 17 17 17 17 17 17 17 163 17 163 17 88 89 81 81 81 81 81 81 81 81 81 81 81 81 81 81 81 81 81 81 81 81 81 81 81 81 89 90 17 17 16 17 17 17 17 17 17 17 17 17 17 17 17 236 237 238 239 228 229 230 231 17 17 17 17 
17 17 17 236 237 238 239 17 17 17 17 17 17 17 17 17 17 17 17 163 17 17 17 17 17 88 89 97 97 97 97 97 97 97 97 97 97 97 97 97 97 97 97 97 97 97 97 97 97 97 97 89 90 17 17 24 17 232 233 234 235 17 17 17 17 17 17 17 17 17 17 17 236 237 238 239 17 17 17 17 
16 17 17 17 17 17 17 17 17 17 17 17 17 17 17 16 17 17 17 17 17 17 17 17 17 88 90 16 18 18 17 17 17 17 17 17 17 17 17 17 17 17 17 17 17 160 161 160 161 17 17 88 90 17 17 32 17 240 241 242 243 17 17 17 17 17 17 17 17 17 17 17 17 17 17 17 17 17 17 17 
24 17 17 17 17 17 17 17 17 17 17 17 17 17 17 24 17 232 233 234 235 17 17 17 17 88 90 24 18 18 17 163 17 17 688 689 690 691 692 693 694 695 630 631 17 168 169 168 169 17 17 88 90 17 17 40 17 248 249 250 251 17 17 17 17 17 17 17 17 17 17 17 17 17 17 17 17 17 17 17 
32 17 160 161 17 17 17 17 17 17 17 17 160 161 17 32 17 240 241 242 243 17 406 406 17 88 90 32 18 18 17 17 17 17 696 697 698 699 700 701 702 703 638 639 17 176 177 176 177 17 17 88 90 157 17 17 163 17 17 17 17 16 17 160 161 17 17 17 17 17 17 17 17 160 161 17 16 17 17 17 
40 17 168 169 17 17 17 17 17 17 17 17 168 169 17 40 17 248 249 250 251 17 414 414 17 88 90 40 160 161 160 161 17 17 704 705 706 707 708 709 710 711 646 647 17 184 185 184 185 17 17 88 90 17 17 17 17 17 17 163 17 24 17 168 169 17 17 17 17 17 17 17 17 168 169 17 24 17 17 17 
17 17 176 177 151 151 151 151 151 151 151 151 176 177 17 17 17 17 17 17 17 17 17 17 17 88 90 17 168 169 168 169 17 17 712 713 714 715 716 717 718 719 654 655 17 17 80 81 81 81 81 89 90 17 163 17 163 17 17 17 17 32 17 176 177 151 151 151 151 151 151 151 151 176 177 17 32 17 17 17 
17 17 184 185 159 159 159 159 159 159 159 159 184 185 17 17 17 17 17 17 17 17 157 17 17 88 90 17 176 177 176 177 17 17 720 721 722 723 724 725 726 727 662 663 17 17 88 89 97 97 97 97 98 17 17 17 17 17 17 17 17 40 17 184 185 159 159 159 159 159 159 159 159 184 185 17 40 17 17 17 
17 17 17 157 157 157 157 157 157 157 157 157 157 17 17 17 17 157 17 163 17 17 17 17 17 88 90 17 184 185 184 185 17 17 728 729 730 731 732 733 734 735 670 671 17 16 88 90 17 17 17 17 17 17 17 17 17 17 17 163 17 17 17 17 157 157 157 157 157 157 157 157 157 157 17 17 17 17 17 17 
17 17 17 149 149 149 149 149 149 149 149 149 149 49 49 49 49 49 49 49 49 49 49 49 17 88 89 81 81 81 81 82 17 17 736 737 738 739 244 244 742 743 678 679 17 24 88 90 17 17 17 17 17 17 17 17 17 17 17 17 17 17 17 17 149 149 149 149 149 149 149 149 149 149 49 17 17 17 17 17 
17 17 17 150 150 150 150 150 150 150 150 150 150 49 17 17 17 17 163 17 17 157 17 17 17 96 97 97 97 97 89 90 17 17 744 745 746 747 252 252 750 751 686 687 17 32 88 90 17 816 817 818 819 820 821 822 823 627 628 17 17 17 17 17 150 150 150 150 150 150 150 150 150 150 49 17 17 17 17 17 
17 17 160 156 156 156 156 156 156 156 156 156 156 161 17 17 17 18 18 18 18 18 18 18 18 18 18 18 18 18 88 90 17 163 17 17 17 17 88 90 17 17 170 171 17 40 88 90 17 824 825 826 827 828 829 830 831 635 636 17 17 17 17 160 156 156 156 156 156 156 156 156 156 156 161 17 17 17 17 17 
17 17 168 169 17 17 17 17 17 17 49 49 168 169 17 17 17 288 288 288 288 288 288 288 288 288 288 17 18 16 88 90 157 17 163 17 17 17 88 90 17 17 178 179 17 17 88 90 17 832 833 834 835 836 837 838 839 643 644 17 17 17 17 168 169 17 17 17 17 17 17 49 49 168 169 17 17 17 17 17 
17 17 176 177 17 17 17 17 17 17 49 49 176 177 17 18 17 378 376 377 378 376 377 378 376 377 378 17 18 24 88 90 17 17 17 17 17 17 88 90 17 17 186 187 17 17 88 90 17 840 841 842 843 844 845 846 847 651 652 17 17 17 17 176 177 17 17 17 17 17 17 49 49 176 177 17 17 17 17 17 
17 17 184 185 17 17 17 17 17 17 49 49 184 185 17 18 17 386 384 385 386 384 385 386 384 385 386 17 17 32 88 89 81 81 81 81 81 81 89 89 81 81 81 81 81 81 89 90 17 848 849 850 851 852 853 854 855 659 660 17 17 17 17 184 185 17 17 17 17 17 17 49 49 184 185 17 17 17 17 17 
16 17 17 17 17 17 17 17 17 17 49 49 49 49 17 16 17 394 392 393 394 392 393 394 392 393 394 17 17 40 88 89 97 97 97 97 97 97 97 97 97 97 97 97 97 97 89 90 16 856 857 858 859 860 861 862 863 667 668 17 17 17 17 17 17 17 17 17 17 17 17 49 49 49 49 17 17 17 17 17 
24 17 17 17 17 17 17 17 17 17 49 49 49 49 17 24 17 288 289 290 291 244 244 288 288 289 290 17 17 17 88 90 17 17 17 17 17 17 17 17 17 17 17 17 17 17 88 90 24 864 865 866 867 868 869 870 871 675 676 17 17 17 257 257 257 257 257 257 257 257 257 257 257 257 17 17 17 17 17 17 
32 17 17 17 17 17 17 17 17 17 17 17 17 18 17 32 17 296 297 298 299 252 252 288 296 297 298 17 406 17 88 90 17 17 17 17 17 17 17 17 17 17 17 17 17 17 88 90 32 872 873 874 875 876 877 878 879 683 684 17 406 17 257 89 89 89 89 89 89 89 89 89 89 257 17 17 17 17 17 17 
40 17 17 17 17 17 17 17 17 17 17 17 17 17 17 40 17 17 17 17 17 88 90 17 17 17 17 17 414 17 88 90 17 17 752 753 754 755 756 757 758 759 624 625 17 17 88 90 40 17 17 17 17 88 90 17 17 17 17 17 414 17 257 89 89 89 89 89 89 89 89 89 89 257 17 17 17 17 17 17 
17 17 17 17 17 17 17 17 17 17 17 17 17 17 17 17 17 17 17 149 17 88 89 81 81 81 81 81 81 81 89 90 17 17 760 761 762 763 764 765 766 767 632 633 17 17 88 89 81 81 81 81 81 89 90 163 17 17 17 17 17 17 257 89 89 257 257 257 257 257 257 89 89 257 17 17 17 17 17 17 
17 17 17 17 17 17 17 17 17 17 17 17 17 17 17 17 149 17 17 17 17 96 97 97 97 97 97 97 97 97 89 90 17 17 768 769 770 771 772 773 774 775 640 641 17 17 96 97 97 97 97 97 97 89 90 17 17 163 17 17 17 17 257 89 89 257 89 89 89 89 257 89 89 257 17 17 17 17 17 17 
17 17 25 26 27 27 27 27 27 26 26 26 28 17 17 17 17 17 149 17 17 17 17 17 17 17 17 17 17 17 88 90 17 17 776 777 778 779 780 781 782 783 648 649 17 17 17 17 17 17 17 17 17 88 90 17 17 17 17 17 17 17 257 89 89 257 89 89 89 89 257 89 89 257 17 17 17 17 17 17 
17 17 33 34 35 35 35 35 35 34 34 34 36 17 17 17 17 17 17 17 17 17 17 17 149 17 17 17 17 17 88 90 17 17 784 785 786 787 788 789 790 791 656 657 17 17 17 17 17 17 17 17 17 88 90 17 157 17 17 17 17 17 257 89 89 257 89 89 89 89 257 89 89 257 17 17 17 17 17 17 
17 17 41 42 43 43 43 43 43 42 42 42 44 17 17 17 17 17 16 17 17 17 17 17 17 17 17 17 17 17 88 90 16 17 792 793 794 795 796 797 798 799 664 665 17 17 17 17 17 163 17 16 17 88 90 17 17 163 17 163 17 17 257 89 89 257 89 89 89 89 257 89 89 257 17 17 17 17 17 17 
17 17 17 17 17 17 17 17 17 17 17 17 17 17 17 17 17 17 24 17 232 233 234 235 17 17 17 17 17 17 88 90 24 17 800 801 802 803 804 805 806 807 672 673 17 17 163 17 17 17 17 24 17 88 90 17 17 17 17 17 17 17 257 89 89 257 257 257 257 257 257 89 89 257 17 17 17 17 17 17 
17 17 17 17 17 17 17 17 17 17 17 17 17 17 17 17 17 17 32 17 240 241 242 243 17 406 406 17 17 17 88 90 32 17 808 809 810 811 812 813 814 815 680 681 17 406 17 17 157 17 17 32 17 88 90 17 17 17 17 17 17 17 257 89 89 89 89 89 89 89 89 89 89 257 17 17 17 17 17 17 
17 17 17 17 17 17 17 17 17 17 17 17 17 17 17 17 17 17 40 17 248 249 250 251 17 414 414 17 17 17 88 90 40 17 17 17 17 17 88 90 17 17 17 17 17 414 17 17 17 17 17 40 17 88 90 17 163 17 17 17 16 17 257 89 89 89 89 89 89 89 89 89 89 257 17 16 17 17 17 17 
17 17 17 17 17 17 17 17 17 17 17 17 17 17 17 17 17 17 17 17 17 17 17 17 17 17 17 17 17 17 88 89 81 81 81 81 81 81 89 89 81 81 81 81 81 81 81 81 81 81 81 81 81 89 90 17 17 17 17 17 24 17 257 257 257 257 257 257 257 257 257 257 257 257 17 24 17 17 17 17 
17 170 171 17 170 171 17 170 171 17 170 171 17 170 171 17 17 17 17 17 17 17 17 17 17 17 17 17 17 17 96 97 97 97 97 97 97 97 97 97 97 97 97 97 97 97 97 97 97 97 97 97 97 97 98 17 17 17 17 163 32 17 17 17 17 17 17 68 68 17 17 17 17 17 17 32 17 17 17 17 
17 178 179 17 178 179 17 178 179 17 178 179 17 178 179 17 17 17 17 17 17 163 17 149 17 17 17 17 17 17 17 17 17 17 17 17 17 17 17 17 17 17 17 17 17 17 17 17 17 17 17 17 17 17 17 17 17 17 17 17 40 17 17 17 17 17 17 76 76 17 17 17 17 17 17 40 17 17 17 17 
17 186 187 17 186 187 17 186 187 17 186 187 17 186 187 17 17 17 17 149 17 17 17 17 17 17 17 17 17 17 17 17 163 17 17 17 149 17 17 17 17 17 17 17 17 17 17 17 17 17 17 17 17 17 17 163 17 17 17 17 17 17 17 17 17 17 17 17 17 17 17 17 17 17 17 17 17 17 17 17 
17 17 17 17 17 17 17 17 17 17 17 17 17 17 17 17 17 17 17 17 17 17 17 17 17 17 163 17 17 17 149 17 17 17 17 17 17 17 163 17 17 17 17 17 17 149 17 17 17 149 17 17 17 17 17 17 17 17 17 17 17 17 17 17 17 17 17 17 17 17 17 17 17 17 17 17 17 17 17 17 
17 17 17 17 17 17 17 17 17 17 17 17 17 17 17 17 17 17 17 17 17 17 17 17 17 17 17 17 17 17 17 17 17 17 17 17 17 17 17 17 149 17 17 17 17 17 17 17 17 17 17 17 17 17 17 17 17 17 17 17 17 17 17 17 17 17 17 17 17 17 17 17 17 17 17 17 17 17 17 17 
128 128 128 128 128 128 128 128 128 128 128 128 128 128 128 128 128 128 128 128 128 129 128 128 128 128 128 128 128 128 128 128 128 128 128 128 128 128 128 128 128 128 128 128 128 128 128 128 128 128 128 128 128 128 129 128 128 128 128 128 128 128 128 128 128 128 128 128 128 128 128 128 128 128 128 128 128 128 128 129 
136 136 136 136 136 136 136 136 136 136 136 136 136 136 136 136 136 136 136 136 136 137 136 136 136 136 136 136 136 136 136 136 136 136 136 136 136 136 136 136 136 136 136 136 136 136 136 136 136 136 136 136 136 136 137 136 136 136 136 136 136 136 136 136 136 136 136 136 136 136 136 136 136 136 136 136 136 136 136 137 
56 56 56 56 56 56 56 56 56 56 56 56 56 56 56 56 56 57 56 56 56 56 56 56 56 56 56 56 56 56 56 56 56 56 56 56 56 56 56 56 56 56 56 56 56 57 56 56 56 56 56 56 56 56 56 56 56 56 56 56 56 56 56 56 57 56 56 56 56 56 56 56 56 56 56 56 56 56 56 57 
64 64 64 64 64 64 64 64 64 64 64 64 64 64 64 64 64 65 64 64 64 64 64 64 64 64 64 64 64 64 64 64 64 64 64 64 64 64 64 64 64 64 64 64 64 65 64 64 64 64 64 64 64 64 64 64 64 64 64 64 64 64 64 64 65 64 64 64 64 64 64 64 64 64 64 64 64 64 64 65 
56 56 56 56 56 56 56 56 56 56 56 56 56 56 56 56 56 56 56 56 56 56 56 56 56 56 56 57 56 56 56 56 56 56 56 56 56 56 56 56 56 56 57 56 56 56 56 56 56 56 56 56 56 56 56 56 56 57 56 56 56 56 56 56 56 56 56 56 56 56 56 56 56 56 56 56 56 56 56 57 
64 64 64 64 64 64 64 64 64 64 64 64 257 57 64 64 64 257 64 64 64 257 64 64 64 64 64 257 64 64 64 257 64 64 64 257 257 257 257 257 64 64 65 257 257 257 257 257 257 64 64 64 64 64 257 64 64 257 257 257 257 257 257 257 64 64 64 64 64 64 64 64 64 64 64 64 64 64 64 65 
56 56 56 56 56 56 56 56 56 56 56 56 257 57 56 56 56 257 56 56 56 257 257 56 56 56 56 257 56 56 56 257 56 56 56 257 56 56 56 56 56 56 56 257 56 56 56 56 257 56 56 56 56 56 257 56 56 56 56 56 257 56 56 56 56 56 56 56 56 56 56 56 56 56 56 56 56 56 56 57 
64 64 64 64 64 64 64 64 64 64 64 64 257 57 64 64 64 257 64 64 64 257 64 257 64 64 64 257 64 64 64 257 64 64 64 257 64 64 64 64 64 64 64 257 64 64 64 64 257 64 64 64 64 64 257 64 64 64 64 64 257 64 64 64 64 64 64 64 64 64 64 64 64 64 64 64 64 64 64 65 
56 56 56 56 56 56 56 56 56 56 56 56 257 57 56 56 56 257 56 56 56 257 56 56 257 56 56 257 56 56 56 257 56 56 56 257 257 257 257 257 56 56 56 257 257 257 257 257 257 56 56 56 56 56 257 56 56 56 56 56 257 56 56 56 56 56 56 56 56 56 56 56 56 56 56 56 56 56 56 57 
64 64 64 64 64 64 64 64 64 64 64 64 257 57 64 64 64 257 64 64 64 257 64 64 64 257 64 257 64 64 64 257 64 64 64 64 64 64 64 257 64 64 64 257 65 64 64 64 257 64 64 64 64 64 257 64 64 64 64 64 257 64 64 64 64 64 64 64 64 64 64 64 64 64 64 64 64 64 64 65 
56 56 56 56 56 56 56 56 56 56 56 56 257 57 56 56 56 257 56 56 56 257 56 56 56 56 257 257 56 56 56 257 56 56 56 56 56 56 56 257 56 56 56 257 56 56 56 56 257 56 56 56 56 56 257 56 56 56 56 57 257 56 56 56 56 56 56 56 56 56 56 56 56 56 56 56 56 56 56 57 
64 64 64 64 64 64 64 64 64 64 64 64 257 257 257 257 257 257 64 64 64 257 64 64 64 64 64 257 64 64 64 257 64 64 64 257 257 257 257 257 64 64 64 257 64 64 64 64 257 64 64 257 64 64 257 64 64 64 64 65 257 64 64 64 64 64 64 64 64 64 64 64 64 64 64 64 64 64 64 65 
56 56 56 56 56 56 56 56 56 56 56 56 56 56 56 56 56 56 56 56 56 56 56 56 56 56 56 56 56 56 56 56 56 56 56 56 56 56 56 56 56 56 56 56 56 56 56 56 56 56 56 56 56 56 56 56 56 56 57 56 56 56 56 56 56 56 56 56 56 56 56 56 56 56 56 56 56 56 56 57 
64 64 64 64 64 64 64 64 64 64 64 64 64 64 64 64 64 64 64 64 64 64 64 64 64 64 64 64 64 64 64 64 64 64 64 64 64 64 64 64 64 64 64 64 64 64 64 64 64 64 64 64 64 64 64 64 64 64 65 64 64 64 64 64 64 64 64 64 64 64 64 64 64 64 64 64 64 64 64 65 
56 56 56 56 56 56 56 56 56 56 56 56 56 56 56 56 56 56 56 56 56 56 56 56 56 56 56 56 56 56 56 56 56 56 56 56 56 57 56 56 56 56 56 56 56 56 56 56 56 56 56 56 56 56 56 57 56 56 56 56 56 56 56 56 56 56 56 56 56 56 56 56 56 56 56 56 56 56 56 56 
64 64 64 64 64 64 64 64 64 64 64 64 64 64 64 64 64 64 64 64 64 64 64 64 64 64 64 64 64 64 64 64 64 64 64 64 64 65 64 64 64 64 64 64 64 64 64 64 64 64 64 64 64 64 64 65 64 64 64 64 64 64 64 64 64 64 64 64 64 64 64 64 64 64 64 64 64 64 64 64 