60
60
163 163 163 163 163 163 163 163 163 163 163 163 163 163 163 163 163 163 163 163 163 163 163 163 163 163 163 163 163 163 163 163 163 163 163 163 163 163 163 163 163 163 163 163 163 163 163 163 163 163 163 163 163 163 163 163 163 163 163 163 
163 163 163 163 163 163 163 163 163 163 163 163 163 163 163 163 163 163 163 163 163 163 163 163 163 163 163 163 163 163 163 163 163 163 163 163 163 163 163 163 163 163 163 163 163 163 163 163 163 163 163 163 163 163 163 163 163 163 163 163 
163 163 163 163 163 163 163 163 163 163 163 163 163 163 163 163 163 163 163 163 163 163 163 163 163 163 163 163 163 163 163 163 163 163 163 163 163 163 163 163 163 163 163 163 163 163 163 163 163 163 163 163 163 163 163 163 163 163 163 163 
163 163 163 163 163 163 163 163 163 163 163 163 163 163 163 163 163 163 163 163 163 163 163 163 163 163 163 163 163 163 163 163 163 163 163 163 163 163 163 163 163 163 163 163 163 163 163 163 163 163 163 163 163 163 163 163 163 163 163 163 
163 163 163 163 163 163 163 163 163 163 163 163 163 163 163 163 163 163 163 163 163 163 163 163 163 163 163 163 163 163 163 163 163 163 163 163 163 163 163 163 163 163 163 163 163 163 163 163 163 163 163 163 163 163 163 163 163 163 163 163 
163 163 163 163 163 163 163 163 163 163 163 163 163 163 163 163 163 163 163 163 163 163 163 163 163 163 163 163 163 163 163 163 163 163 163 163 163 163 163 163 163 163 163 163 163 163 163 163 163 163 163 163 163 163 163 163 163 163 163 163 
163 163 163 163 163 163 163 162 162 162 162 162 162 162 162 162 162 162 162 162 162 162 162 162 162 162 162 162 162 162 162 162 162 162 162 162 162 162 162 162 162 162 162 162 162 162 162 162 162 162 162 162 162 163 163 163 163 163 163 163 
163 163 163 163 163 163 163 162 163 173 173 163 163 163 163 163 163 163 163 163 163 163 163 163 163 163 163 163 163 163 163 163 163 163 163 163 163 163 163 163 163 163 163 163 163 163 163 163 163 163 163 163 162 163 163 163 163 163 163 163 
163 163 163 163 163 163 163 162 163 173 173 163 163 163 163 163 163 163 163 163 163 163 163 163 163 163 163 163 163 163 163 165 165 165 165 7 8 9 10 11 12 12 12 7 8 9 10 165 165 165 165 163 162 163 163 163 163 163 163 163 
163 163 163 163 163 163 163 162 163 36 37 163 163 163 163 163 163 163 163 163 163 163 163 163 163 163 163 163 163 163 163 165 165 165 165 167 168 169 170 171 172 172 172 167 168 169 170 165 165 165 165 163 162 163 163 163 163 163 163 163 
163 163 163 163 163 163 163 162 163 36 37 163 163 163 163 163 163 163 163 163 163 163 163 163 163 163 163 163 163 163 163 165 165 165 165 36 36 36 36 36 36 36 36 36 36 36 36 165 165 165 165 163 162 163 163 163 163 163 163 163 
163 163 163 163 163 163 163 162 163 36 37 163 163 163 163 163 163 163 163 163 163 163 163 163 163 163 163 163 163 163 163 165 165 165 165 36 38 39 38 39 38 38 38 39 38 39 36 165 165 165 165 163 162 163 163 163 163 163 163 163 
163 163 163 163 163 163 163 162 163 36 37 163 163 163 163 163 163 163 163 163 163 163 163 163 163 163 163 163 163 163 163 165 165 165 165 36 198 199 198 199 36 36 198 199 198 199 36 165 165 165 165 163 162 163 163 163 163 163 163 163 
163 163 163 163 163 163 163 162 163 36 37 163 163 163 163 163 163 163 163 163 163 163 163 163 163 163 163 163 163 163 163 165 165 165 165 36 38 39 38 39 36 36 38 39 38 39 36 165 165 165 165 163 162 163 163 163 163 163 163 163 
163 163 163 163 163 163 163 162 163 36 37 163 163 163 163 163 163 80 81 82 83 84 85 86 87 88 89 163 163 163 163 165 165 165 165 36 198 199 198 199 38 38 198 199 198 199 36 165 165 165 165 163 162 163 163 163 163 163 163 163 
163 163 163 163 163 163 163 162 163 36 37 163 163 163 163 163 163 240 241 242 243 244 245 246 247 248 249 163 163 163 163 165 165 165 165 36 36 36 36 36 36 36 36 36 36 36 36 165 165 165 165 163 162 163 163 163 163 163 163 163 
163 163 163 163 163 163 163 162 163 36 37 163 163 163 163 163 163 90 91 92 93 94 95 96 97 98 99 163 163 163 163 165 165 165 165 165 165 165 165 165 36 37 165 165 165 165 165 165 165 165 165 163 162 163 163 163 163 163 163 163 
163 163 163 163 163 163 163 162 163 36 37 163 163 163 163 163 163 250 251 252 253 254 255 256 257 258 259 163 163 163 163 165 165 165 165 165 165 165 165 165 196 197 165 165 165 165 165 165 165 165 165 163 162 163 163 163 163 163 163 163 
163 163 163 163 163 163 163 162 163 36 37 163 163 163 163 163 163 100 101 102 103 104 105 106 107 108 109 163 163 163 163 165 165 165 165 165 165 165 165 165 196 197 165 165 165 165 165 165 165 165 165 163 162 163 163 163 163 163 163 163 
163 163 163 163 163 163 163 162 163 196 197 163 163 163 163 163 163 260 261 262 263 264 265 266 267 268 269 163 163 163 163 165 165 165 165 165 165 165 165 165 196 197 165 165 165 165 165 165 165 165 165 163 162 163 163 163 163 163 163 163 
163 163 163 163 163 163 163 162 163 36 37 163 163 163 163 163 163 110 111 112 113 114 115 116 117 118 119 163 163 163 163 163 163 163 163 163 163 163 163 163 196 197 163 163 163 163 163 163 163 163 163 163 162 163 163 163 163 163 163 163 
163 163 163 163 163 163 163 162 163 36 37 163 163 163 163 163 163 270 271 272 273 274 275 276 277 278 279 163 163 163 163 163 163 163 163 163 163 163 163 163 196 197 163 163 163 163 163 163 163 163 163 163 162 163 163 163 163 163 163 163 
163 163 163 163 163 163 163 162 163 196 197 163 163 163 163 163 163 163 163 163 163 36 37 163 163 163 163 163 163 163 163 163 163 163 163 163 163 163 163 163 196 197 163 163 163 163 163 163 163 163 163 163 162 163 163 163 163 163 163 163 
163 163 163 163 163 163 163 162 163 36 36 36 36 36 36 36 36 36 36 36 37 36 36 37 37 37 37 37 37 37 37 37 163 163 163 163 163 163 163 163 36 36 36 36 36 36 36 36 37 163 163 163 162 163 163 163 163 163 163 163 
163 163 163 163 163 163 163 162 163 196 196 196 196 196 196 196 196 196 196 196 197 196 196 197 197 197 197 197 197 197 197 197 163 163 163 163 163 163 163 163 196 196 196 196 196 196 196 36 37 163 163 163 162 163 163 163 163 163 163 163 
163 163 163 163 163 163 163 162 163 163 163 163 163 163 163 163 163 163 163 163 163 163 163 163 163 163 163 163 163 163 36 37 163 163 163 163 163 163 163 163 163 163 163 163 163 163 163 36 37 163 163 163 162 163 163 163 163 163 163 163 
163 163 163 163 163 163 163 162 163 163 163 163 163 163 163 163 163 163 163 163 163 163 163 163 163 163 163 163 163 163 36 37 163 163 120 121 122 123 124 125 126 127 128 129 163 163 163 36 37 163 163 163 162 163 163 163 163 163 163 163 
163 163 163 163 163 163 163 162 163 163 163 163 163 163 163 163 163 163 163 163 163 163 163 163 163 163 163 163 163 163 36 37 163 163 280 281 282 283 284 285 286 287 288 289 163 163 163 36 37 163 163 163 162 163 163 163 163 163 163 163 
163 163 163 163 163 163 163 162 163 163 163 163 163 163 163 163 163 163 163 163 163 163 163 163 163 163 163 163 163 163 36 37 163 163 130 131 132 133 134 135 136 137 138 139 163 163 163 36 37 163 163 163 162 163 163 163 163 163 163 163 
163 163 163 163 163 163 163 162 163 163 163 163 163 163 163 163 163 163 163 163 163 163 163 163 163 163 163 163 163 163 36 37 163 163 290 291 292 293 294 295 296 297 298 299 163 163 163 36 37 163 163 163 162 163 163 163 163 163 163 163 
163 163 163 163 163 163 163 162 163 163 163 163 163 163 163 163 163 163 163 163 163 163 163 163 163 163 163 163 163 163 36 37 163 163 140 141 142 143 144 145 146 147 148 149 163 163 163 36 37 163 163 163 162 163 163 163 163 163 163 163 
163 163 163 163 163 163 163 162 163 163 163 163 163 163 163 163 163 163 163 163 163 163 163 163 163 163 163 163 163 163 36 37 163 163 300 301 302 303 304 305 306 307 308 309 163 163 163 196 197 163 163 163 162 163 163 163 163 163 163 163 
163 163 163 163 163 163 163 162 163 163 163 163 163 163 163 163 163 163 163 163 163 163 163 163 163 163 163 163 163 163 36 37 163 163 150 151 152 153 154 155 156 157 158 159 163 163 163 36 37 163 163 163 162 163 163 163 163 163 163 163 
163 163 163 163 163 163 163 162 163 163 163 163 163 163 163 163 163 163 163 163 163 163 163 163 163 163 163 163 163 163 36 37 163 163 310 311 312 313 314 315 316 317 318 319 163 163 163 36 37 163 163 163 162 163 163 163 163 163 163 163 
163 163 163 163 163 163 163 162 163 163 163 163 163 163 163 163 163 163 163 163 163 163 163 163 163 163 163 163 163 163 196 197 163 163 163 163 163 163 36 37 163 163 163 163 163 163 163 196 197 163 163 163 162 163 163 163 163 163 163 163 
163 163 163 163 163 163 163 162 163 163 163 163 163 163 163 163 163 163 163 163 163 163 163 163 163 163 163 163 163 163 36 37 36 36 36 36 36 36 37 197 36 36 36 36 36 36 36 36 37 163 163 163 162 163 163 163 163 163 163 163 
163 163 163 163 163 163 163 162 163 163 163 163 163 163 163 163 163 163 163 163 163 163 163 163 163 163 163 163 163 163 196 197 196 196 196 196 196 196 197 197 196 196 196 196 196 196 196 196 197 163 163 163 162 163 163 163 163 163 163 163 
163 163 163 163 163 163 163 162 163 163 163 163 163 163 163 163 163 163 163 163 163 163 163 163 163 163 163 163 163 163 163 163 163 163 163 163 163 163 36 37 163 163 163 163 163 163 163 163 163 163 163 163 162 163 163 163 163 163 163 163 
163 163 163 163 163 163 163 162 163 163 163 40 41 42 43 44 45 46 47 48 49 163 163 163 163 163 163 163 163 163 163 163 163 163 163 163 163 163 36 37 163 163 163 163 163 163 163 163 163 163 163 163 162 163 163 163 163 163 163 163 
163 163 163 163 163 163 163 162 163 163 163 200 201 202 203 204 205 206 207 208 209 163 163 163 163 163 163 163 163 163 163 163 163 163 163 163 163 163 36 37 163 163 163 163 163 163 163 163 163 163 163 163 162 163 163 163 163 163 163 163 
163 163 163 163 163 163 163 162 163 163 163 50 51 52 53 54 55 56 57 58 59 163 163 163 163 163 163 163 163 163 163 163 163 163 163 163 163 163 36 37 163 163 163 163 163 163 163 163 163 163 163 163 162 163 163 163 163 163 163 163 
163 163 163 163 163 163 163 162 163 163 163 210 211 212 213 214 215 216 217 218 219 163 163 163 163 163 163 163 163 163 163 163 163 163 163 163 163 163 36 37 163 163 163 163 163 163 163 163 163 163 163 163 162 163 163 163 163 163 163 163 
163 163 163 163 163 163 163 162 163 163 163 60 61 62 63 64 65 66 67 68 69 163 163 163 163 163 163 163 163 163 163 163 163 163 163 163 163 163 36 37 163 163 163 163 163 163 163 163 163 163 163 163 162 163 163 163 163 163 163 163 
163 163 163 163 163 163 163 162 163 163 163 220 221 222 223 224 225 226 227 228 229 163 163 163 163 163 163 163 163 163 163 163 163 163 163 163 163 163 36 37 163 163 163 163 163 163 163 163 163 163 163 163 162 163 163 163 163 163 163 163 
163 163 163 163 163 163 163 162 163 163 163 70 71 72 73 74 75 76 77 78 79 163 163 163 163 163 163 163 163 163 163 163 163 163 163 163 163 163 36 37 163 163 163 163 163 163 163 163 163 163 163 163 162 163 163 163 163 163 163 163 
163 163 163 163 163 163 163 162 163 163 163 230 231 232 233 234 235 236 237 238 239 163 163 163 163 163 163 163 163 163 163 163 163 163 163 163 163 163 36 37 163 163 163 163 163 163 163 163 163 163 163 163 162 163 163 163 163 163 163 163 
163 163 163 163 163 163 163 162 163 163 163 163 163 163 163 36 37 163 163 163 163 163 163 163 163 163 163 163 163 163 163 163 163 163 163 163 163 163 196 197 163 163 163 163 163 163 163 163 163 163 163 163 162 163 163 163 163 163 163 163 
163 163 163 163 163 163 163 162 163 163 163 163 163 163 163 196 197 36 36 36 36 36 36 36 36 36 36 36 37 36 36 36 36 36 36 36 36 36 36 37 163 163 163 163 163 163 163 163 163 163 163 163 162 163 163 163 163 163 163 163 
163 163 163 163 163 163 163 162 163 163 163 163 163 163 163 196 197 196 196 196 196 196 196 196 196 196 196 196 197 196 196 196 196 196 196 196 196 196 196 197 163 163 163 163 163 163 163 163 163 163 163 163 162 163 163 163 163 163 163 163 
163 163 163 163 163 163 163 162 163 163 163 163 163 163 163 163 163 163 163 163 163 163 163 163 163 163 163 163 163 163 163 163 163 163 163 163 163 163 163 163 163 163 163 163 163 163 163 163 163 163 163 163 162 163 163 163 163 163 163 163 
163 163 163 163 163 163 163 162 163 163 163 163 163 163 163 163 163 163 163 163 163 163 163 163 163 163 163 163 163 163 163 163 163 163 163 163 163 163 163 163 163 163 163 163 163 163 163 163 163 163 163 163 162 163 163 163 163 163 163 163 
163 163 163 163 163 163 163 162 163 163 163 163 163 163 163 163 163 163 163 163 163 163 163 163 163 163 163 163 163 163 163 163 163 163 163 163 163 163 163 163 163 163 163 163 163 163 163 163 163 163 163 163 162 163 163 163 163 163 163 163 
163 163 163 163 163 163 163 162 163 163 163 163 163 163 163 163 163 163 163 163 163 163 163 163 163 163 163 163 163 163 163 163 163 163 163 163 163 163 163 163 163 163 163 163 163 163 163 163 163 163 163 163 162 163 163 163 163 163 163 163 
163 163 163 163 163 163 163 162 162 162 162 162 162 162 162 162 162 162 162 162 162 162 162 162 162 162 162 162 162 162 162 162 162 162 162 162 162 162 162 162 162 162 162 162 162 162 162 162 162 162 162 162 162 163 163 163 163 163 163 163 
163 163 163 163 163 163 163 163 163 163 163 163 163 163 163 163 163 163 163 163 163 163 163 163 163 163 163 163 163 163 163 163 163 163 163 163 163 163 163 163 163 163 163 163 163 163 163 163 163 163 163 163 163 163 163 163 163 163 163 163 
163 163 163 163 163 163 163 163 163 163 163 163 163 163 163 163 163 163 163 163 163 163 163 163 163 163 163 163 163 163 163 163 163 163 163 163 163 163 163 163 163 163 163 163 163 163 163 163 163 163 163 163 163 163 163 163 163 163 163 163 
163 163 163 163 163 163 163 163 163 163 163 163 163 163 163 163 163 163 163 163 163 163 163 163 163 163 163 163 163 163 163 163 163 163 163 163 163 163 163 163 163 163 163 163 163 163 163 163 163 163 163 163 163 163 163 163 163 163 163 163 
163 163 163 163 163 163 163 163 163 163 163 163 163 163 163 163 163 163 163 163 163 163 163 163 163 163 163 163 163 163 163 163 163 163 163 163 163 163 163 163 163 163 163 163 163 163 163 163 163 163 163 163 163 163 163 163 163 163 163 163 
163 163 163 163 163 163 163 163 163 163 163 163 163 163 163 163 163 163 163 163 163 163 163 163 163 163 163 163 163 163 163 163 163 163 163 163 163 163 163 163 163 163 163 163 163 163 163 163 163 163 163 163 163 163 163 163 163 163 163 163 
163 163 163 163 163 163 163 163 163 163 163 163 163 163 163 163 163 163 163 163 163 163 163 163 163 163 163 163 163 163 163 163 163 163 163 163 163 163 163 163 163 163 163 163 163 163 163 163 163 163 163 163 163 163 163 163 163 163 163 163 