1
74
29
198 199 48 48 196 197 198 199 48 48 196 197 198 199 48 48 196 197 198 199 48 48 196 197 198 199 608 609 610 611 612 613 614 615 550 551 196 197 198 199 48 48 196 197 198 199 48 48 196 197 198 199 48 48 196 197 198 199 48 48 196 197 198 199 48 48 196 197 198 199 48 48 196 197 
206 207 48 48 204 205 206 207 48 48 204 205 206 207 48 48 204 205 206 207 48 48 204 205 206 207 616 617 618 619 620 621 622 623 558 559 204 205 206 207 48 48 204 205 206 207 48 48 204 205 206 207 48 48 204 205 206 207 48 48 204 205 206 207 48 48 204 205 206 207 48 48 204 205 
214 215 48 48 212 213 214 215 48 48 212 213 214 215 48 48 212 213 214 215 48 48 212 213 214 215 48 48 48 48 48 48 48 48 48 48 212 213 214 215 48 48 212 213 214 215 48 48 212 213 214 215 48 48 212 213 214 215 48 48 212 213 214 215 48 48 212 213 214 215 48 48 212 213 
222 223 48 48 220 221 222 223 48 48 220 221 222 223 48 48 220 221 222 223 48 48 220 221 222 223 48 48 48 48 48 48 48 48 48 48 220 221 222 223 48 48 220 221 222 223 48 48 220 221 222 223 48 48 220 221 222 223 48 48 220 221 222 223 48 48 220 221 222 223 48 48 220 221 
230 231 48 48 228 229 230 231 48 48 228 229 230 231 48 48 228 229 230 231 48 48 228 229 230 231 48 48 151 151 151 151 151 151 295 295 295 295 295 295 295 295 295 295 295 295 295 295 295 295 295 295 295 295 295 295 295 295 295 295 295 295 295 295 295 295 295 295 295 295 295 295 295 295 
238 239 48 48 236 237 238 239 48 48 236 237 238 239 48 48 236 237 238 239 48 48 236 237 238 239 48 48 159 159 159 159 159 159 288 288 352 352 352 288 288 288 288 288 288 288 288 288 288 288 288 288 288 288 288 288 288 688 689 690 691 692 693 694 695 630 631 288 288 288 288 288 288 288 
129 129 129 129 129 129 129 129 129 129 129 129 129 129 129 129 129 129 129 129 129 129 129 129 129 129 129 130 158 232 233 234 235 158 296 296 392 393 394 296 296 296 296 296 296 296 296 296 296 296 296 296 296 296 296 298 299 696 697 698 699 700 701 702 703 638 639 296 296 296 296 296 296 296 
137 137 137 137 137 137 137 137 137 137 137 137 137 137 137 137 137 137 137 137 137 137 137 137 137 137 137 138 158 240 241 242 243 158 311 311 311 311 311 311 311 311 311 311 311 311 311 311 311 311 311 311 311 311 311 311 311 704 705 706 707 708 709 710 711 646 647 311 311 311 311 311 311 311 
48 166 48 16 48 48 48 48 48 48 148 48 48 48 48 16 48 48 48 48 48 48 48 48 48 48 48 48 48 248 249 250 251 16 170 171 163 48 170 171 21 48 170 171 431 16 170 171 100 48 170 171 45 46 170 171 48 712 713 714 715 716 717 718 719 654 655 45 46 48 16 170 171 163 
48 48 48 24 150 48 48 156 48 48 48 48 48 150 48 24 48 48 48 139 48 48 48 150 48 48 48 48 48 88 4 4 90 24 178 179 164 48 178 179 48 163 178 179 48 24 178 179 48 48 178 179 48 48 178 179 48 720 721 722 723 724 725 726 727 662 663 48 154 47 24 178 179 48 
149 48 48 32 406 48 139 48 150 48 48 246 48 148 48 32 406 48 48 48 154 48 48 154 48 48 48 48 48 88 4 4 90 32 186 187 48 154 186 187 47 48 186 187 406 32 186 187 48 431 186 187 48 423 186 187 406 728 729 730 731 732 733 734 735 670 671 48 48 406 32 186 187 154 
50 51 156 40 414 156 48 49 50 48 48 49 50 51 52 40 414 156 48 49 80 81 81 81 81 81 81 81 81 83 4 4 90 40 339 163 50 100 52 431 54 412 48 49 414 40 339 21 50 47 154 48 163 48 412 412 414 736 737 738 739 244 244 742 743 678 679 163 48 414 40 48 21 50 
337 337 337 337 337 337 337 337 337 337 337 337 337 337 337 337 337 337 337 337 88 4 4 4 4 4 4 4 4 4 4 4 90 337 337 337 337 337 337 337 337 337 337 337 337 337 337 337 337 337 337 337 337 337 337 337 337 744 745 746 747 252 252 750 751 686 687 337 337 337 337 337 337 337 
81 81 81 81 81 81 81 81 81 81 81 81 81 81 81 81 81 81 81 81 83 4 107 258 258 258 258 258 258 258 108 4 84 81 81 81 81 81 81 81 81 81 81 81 81 81 81 81 81 81 81 81 81 81 81 81 81 81 81 81 81 81 81 81 81 81 81 81 81 81 81 81 81 81 
4 4 4 4 4 4 4 4 4 4 4 4 4 4 4 4 4 4 4 4 4 4 115 257 254 254 254 254 254 257 116 4 4 4 4 4 4 4 4 4 4 4 4 4 4 4 4 4 4 4 4 4 4 4 4 4 4 4 4 4 4 4 4 4 4 4 4 4 4 4 4 4 4 4 
97 97 97 97 97 97 97 97 97 97 97 97 97 97 97 97 97 97 97 97 91 4 123 258 258 258 258 258 258 258 124 4 92 97 97 97 97 97 97 97 97 97 97 97 97 97 97 97 97 97 97 97 97 97 97 97 97 97 97 97 97 97 97 97 97 97 97 97 97 97 97 97 97 97 
321 321 321 321 321 321 321 321 321 132 133 321 321 321 321 132 133 321 321 321 88 4 4 4 4 4 4 4 4 4 4 4 90 321 321 321 321 321 321 132 133 321 321 321 321 132 133 321 321 321 321 321 321 321 321 321 321 321 321 321 321 321 321 321 321 132 133 321 321 321 321 132 133 321 
48 156 48 48 48 48 148 48 48 48 48 139 48 48 48 48 48 48 139 48 96 97 97 97 97 97 97 97 97 97 97 97 98 17 170 171 154 17 170 171 17 163 170 171 17 17 170 171 100 52 170 171 163 431 170 171 20 52 170 171 17 17 170 171 52 52 170 171 52 20 170 171 52 52 
149 55 160 161 148 406 160 161 48 246 160 161 149 48 160 161 150 48 48 48 48 100 48 25 26 26 26 26 27 28 55 55 55 55 178 179 55 154 178 179 55 154 178 179 55 48 178 179 48 48 178 179 154 48 178 179 51 163 178 179 55 431 178 179 48 48 178 179 154 48 178 179 51 163 
54 55 168 169 48 414 168 169 48 48 168 169 48 48 168 169 48 48 48 48 148 48 48 33 34 34 34 35 35 36 54 164 54 54 186 187 55 55 186 187 55 55 186 187 55 48 186 187 48 48 186 187 48 47 186 187 51 816 817 818 819 820 821 822 823 627 628 187 48 47 186 187 51 52 
55 55 176 177 48 48 176 177 48 48 176 177 48 48 176 177 48 48 48 48 55 55 48 41 42 42 42 43 43 44 54 55 55 55 55 55 163 54 55 431 54 47 55 55 55 47 55 55 48 20 55 30 30 31 55 55 423 824 825 826 827 828 829 825 826 826 636 100 48 163 55 55 423 52 
52 156 184 185 55 139 184 185 150 48 184 185 48 148 184 185 48 150 48 158 158 158 48 48 327 48 48 100 327 54 51 158 158 158 55 100 54 164 47 55 100 54 154 55 164 154 163 55 45 46 55 38 38 39 55 412 49 832 833 834 835 836 837 838 839 643 644 55 48 100 55 431 49 20 
181 181 181 181 181 181 181 181 181 181 181 181 181 181 181 181 181 181 181 59 60 61 181 181 181 181 181 181 181 181 181 59 60 61 181 181 181 181 181 181 181 181 181 181 181 181 181 181 181 181 181 181 181 181 181 181 181 840 841 842 843 844 845 846 847 651 652 181 181 181 181 181 181 181 
189 189 189 189 189 189 189 189 189 189 189 189 189 189 189 189 189 189 189 67 68 69 189 189 189 189 189 189 189 189 189 67 68 69 189 189 189 189 189 189 189 189 189 189 189 189 189 189 189 189 189 189 189 189 189 189 189 848 849 850 851 852 853 854 855 659 660 189 189 189 189 189 189 190 
272 272 272 272 272 272 272 272 272 272 272 272 272 272 272 272 272 272 272 256 257 258 272 272 272 272 272 272 272 272 272 256 257 258 272 272 272 272 272 272 272 272 272 272 272 272 272 272 272 272 272 272 272 272 272 272 272 856 857 858 859 860 861 862 863 667 668 272 272 272 272 272 272 272 
9 132 133 9 9 9 9 9 9 9 9 9 9 9 9 132 133 9 9 256 257 258 9 9 9 9 9 9 9 9 9 256 257 258 9 9 132 133 9 9 9 9 9 9 9 9 9 9 9 9 132 133 9 9 9 9 9 864 865 866 867 868 869 870 871 675 676 9 9 9 9 9 9 9 
9 9 9 9 9 9 9 9 9 9 9 9 9 9 9 9 9 9 9 256 257 258 9 9 9 9 9 9 9 9 9 256 257 258 9 9 9 9 9 9 9 9 9 9 9 9 9 9 9 9 9 9 9 9 9 9 9 872 873 874 875 876 877 878 879 879 684 9 9 9 9 9 9 9 
9 9 9 9 9 9 9 9 9 9 9 9 9 9 9 9 9 9 9 257 257 257 9 9 9 9 9 9 9 9 9 257 257 257 9 9 9 9 9 9 9 9 9 9 9 9 9 9 9 9 9 9 9 9 9 9 9 257 257 257 257 257 257 257 257 257 257 9 9 9 9 9 9 9 
257 257 257 257 257 257 257 257 257 257 257 257 257 257 257 257 257 257 257 257 257 257 257 257 257 257 257 257 257 257 257 257 257 257 257 257 257 257 257 257 257 257 257 257 257 257 257 257 257 257 257 257 257 257 257 257 257 257 257 257 257 257 257 257 257 257 257 257 257 257 257 257 257 257 