100
20
0 228 229 230 231 0 0 228 229 230 231 0 0 228 229 230 231 0 0 0 228 229 230 231 0 0 228 229 230 231 0 0 228 229 230 231 0 0 228 229 230 231 151 151 151 151 151 151 288 289 376 377 378 291 288 289 290 291 291 291 291 291 291 288 291 291 291 291 291 291 289 290 291 291 291 291 291 376 377 378 291 291 291 291 291 291 291 291 291 291 291 291 291 288 288 288 288 288 288 288 
0 236 237 238 239 0 0 236 237 238 239 0 0 236 237 238 239 0 0 0 236 237 238 239 0 0 236 237 238 239 0 0 236 237 238 239 0 0 236 237 238 239 159 159 159 159 159 159 288 288 384 385 386 288 288 288 288 288 288 288 288 288 288 288 288 288 288 288 288 288 288 288 288 288 288 288 288 384 385 386 288 288 288 288 288 288 288 288 288 288 288 288 288 288 288 688 689 690 691 692 
128 129 129 129 129 129 129 129 129 129 129 129 129 129 129 129 129 129 129 129 129 129 129 129 129 129 129 129 129 129 129 129 129 129 129 129 129 129 129 129 129 130 158 232 233 234 235 158 296 296 392 393 394 296 296 296 296 296 296 296 296 296 296 296 296 296 297 298 296 296 296 296 296 296 296 296 296 392 393 394 296 296 296 296 296 296 296 296 296 296 296 296 296 298 299 696 697 698 699 700 
136 137 137 137 137 137 137 137 137 137 137 137 137 137 137 137 137 137 137 137 137 137 137 137 137 137 137 137 137 137 137 137 137 137 137 137 137 137 137 137 137 138 158 240 241 242 243 158 311 311 311 311 311 311 311 311 311 311 311 311 311 311 311 311 311 311 311 311 311 311 311 311 311 311 311 311 311 311 311 311 311 311 311 311 311 311 311 311 311 311 311 311 311 311 311 704 705 706 707 708 
148 48 48 166 48 16 48 48 48 48 48 48 148 48 48 48 48 16 48 48 48 48 48 48 246 48 48 148 48 16 48 48 48 48 48 48 48 48 48 48 48 48 48 248 249 250 251 16 48 48 48 48 48 48 21 48 48 48 48 16 164 48 100 48 48 48 48 163 48 48 48 16 48 47 48 48 48 45 46 48 163 48 48 16 20 48 170 171 412 170 171 48 163 48 48 712 713 714 715 716 
48 139 48 48 48 24 150 48 48 156 48 48 48 48 48 150 48 24 48 48 48 139 48 48 48 48 48 48 48 24 48 48 48 148 48 48 48 150 48 48 48 48 48 88 4 4 90 24 154 48 164 48 48 48 48 48 154 47 48 24 48 48 48 48 48 48 48 48 48 48 48 24 48 48 48 48 48 48 48 48 48 48 48 24 48 48 178 179 48 178 179 48 48 45 46 720 721 722 723 724 
48 48 149 48 48 32 406 48 139 48 150 48 48 246 48 148 48 32 406 48 48 48 48 48 48 150 48 48 48 32 406 246 48 48 154 48 48 154 48 48 48 48 48 88 4 4 90 32 406 48 48 48 163 48 48 48 48 48 48 32 412 48 48 154 48 48 48 48 45 46 48 32 48 163 48 48 48 48 30 30 31 31 48 32 48 48 186 187 162 186 187 423 48 406 406 728 729 730 731 732 
246 49 50 51 156 40 414 156 48 49 50 48 48 49 50 51 52 40 414 156 48 49 150 48 48 49 50 51 52 40 414 55 48 49 80 81 81 81 81 81 81 81 81 83 4 4 90 40 414 163 50 51 52 48 54 412 48 49 50 40 48 49 50 51 47 48 339 55 48 49 50 40 48 49 50 47 412 48 38 38 39 39 48 40 48 21 50 51 52 48 163 48 412 414 414 736 737 738 739 740 
337 337 337 337 337 337 337 337 337 337 337 337 337 337 337 337 337 337 337 337 337 337 337 337 337 337 337 337 337 337 337 337 337 337 88 4 4 4 4 4 4 4 4 4 4 4 90 337 337 337 337 337 337 337 337 337 337 337 337 337 337 337 337 337 337 337 337 337 337 337 337 337 337 337 337 337 337 337 337 337 337 337 337 337 337 337 337 337 337 337 337 337 337 337 337 744 745 746 747 748 
81 81 81 81 81 81 81 81 81 81 81 81 81 81 81 81 81 81 81 81 81 81 81 81 81 81 81 81 81 81 81 81 81 81 83 4 107 256 256 256 256 256 256 256 108 4 84 81 81 81 81 81 81 81 81 81 81 81 81 81 81 81 81 81 81 81 81 81 81 81 81 81 81 81 81 81 81 81 81 81 81 81 81 81 81 81 81 81 81 81 81 81 81 81 81 81 81 244 245 245 
4 4 4 4 4 4 4 4 4 4 4 4 4 4 4 4 4 4 4 4 4 4 4 4 4 4 4 4 4 4 4 4 4 4 4 4 115 256 254 254 254 254 254 256 116 4 4 4 4 4 4 4 4 4 4 4 4 4 4 4 4 4 4 4 4 4 4 4 4 4 4 4 4 4 4 4 4 4 4 4 4 4 4 4 4 4 4 4 4 4 4 4 4 4 4 4 4 244 245 245 
97 97 97 97 97 97 97 97 97 97 97 97 97 97 97 97 97 97 97 97 97 97 97 97 97 97 97 97 97 97 97 97 97 97 4 4 123 257 258 258 257 258 258 256 124 4 92 97 97 97 97 97 97 97 97 97 97 97 97 97 97 97 97 97 97 97 97 97 97 97 97 97 97 97 97 97 97 97 97 97 97 97 97 97 97 97 97 97 97 97 97 97 97 97 97 97 97 244 245 245 
321 321 321 321 321 321 321 321 321 321 321 132 133 321 321 321 321 132 133 321 321 321 321 321 321 321 321 321 321 321 321 321 321 321 88 4 4 4 4 4 4 4 4 4 4 4 90 321 321 321 321 321 321 321 321 321 321 321 321 132 133 321 321 321 321 132 133 321 321 321 321 321 321 321 321 321 321 321 321 321 321 321 321 321 321 321 321 132 133 321 321 321 321 132 133 321 321 321 321 321 
100 48 48 156 48 48 48 48 148 48 48 48 48 139 48 48 48 48 48 48 139 48 48 48 48 48 48 48 49 50 51 52 53 148 96 97 97 97 97 97 97 97 97 97 97 97 98 17 154 17 17 17 17 17 17 17 412 17 17 17 17 17 17 17 17 17 17 17 17 17 17 17 17 17 17 47 17 17 406 52 52 52 21 52 52 162 52 52 52 52 52 52 52 52 52 52 47 52 52 423 
160 161 149 55 160 161 148 406 160 161 48 246 160 161 149 48 160 161 150 48 160 161 246 48 166 161 164 48 48 148 48 48 48 48 48 100 48 25 26 26 26 27 27 28 55 55 55 55 55 50 55 154 55 55 55 154 55 55 55 48 48 48 154 20 48 48 48 48 48 48 47 48 48 48 154 48 48 48 414 163 48 48 48 20 48 100 48 48 47 48 154 48 423 50 51 163 53 54 55 55 
168 169 54 55 168 169 48 414 168 169 48 48 168 169 48 48 168 169 48 48 168 169 48 48 168 169 48 48 168 169 48 48 406 48 148 48 48 33 34 34 34 35 35 36 54 164 54 54 170 171 55 55 170 171 55 55 170 171 55 48 170 171 48 48 170 171 48 163 170 171 48 48 170 171 48 423 170 171 48 48 170 171 48 48 170 171 48 48 170 171 48 48 170 171 51 52 170 171 55 47 
176 177 55 55 176 177 48 48 176 177 48 48 176 177 48 48 176 177 48 48 176 177 48 48 176 177 48 150 176 177 48 48 414 55 55 55 48 41 42 42 42 43 43 44 54 55 55 55 178 179 163 54 178 179 54 54 178 179 55 47 178 179 48 411 178 179 48 48 178 179 48 48 178 179 48 48 178 179 48 48 178 179 48 21 178 179 48 48 178 179 48 48 178 179 423 52 178 179 55 163 
184 185 52 156 184 185 55 139 184 185 150 48 184 185 48 148 184 185 48 150 184 185 48 166 184 185 48 48 184 185 48 156 48 158 158 158 48 48 327 48 48 100 327 54 51 158 158 158 186 187 54 164 186 187 54 54 186 187 164 154 186 187 48 48 186 187 48 48 186 187 48 48 186 187 48 100 186 187 48 48 186 187 48 154 186 187 45 46 186 187 48 100 186 187 49 20 186 187 47 54 
180 181 181 181 181 181 181 181 181 181 181 181 181 181 181 181 181 181 181 181 181 181 181 181 181 181 181 181 181 181 181 181 181 59 60 61 181 181 181 181 181 181 181 181 181 59 60 61 181 181 181 181 181 181 181 181 181 181 181 181 181 181 181 181 181 181 181 181 181 181 181 181 181 181 181 181 181 181 181 181 181 181 181 181 181 181 181 181 181 181 181 181 181 181 181 181 181 181 181 182 
188 189 189 189 189 189 189 189 189 189 189 189 189 189 189 189 189 189 189 189 189 189 189 189 189 189 189 189 189 189 189 189 189 67 68 69 189 189 189 189 189 189 189 189 189 67 68 69 189 189 189 189 189 189 189 189 189 189 189 189 189 189 189 189 189 189 189 189 189 189 189 189 189 189 189 189 189 189 189 189 189 189 189 189 189 189 189 189 189 189 189 189 189 189 189 189 189 189 189 190 