10
10
1 1 1 1 1 1 1 1 1 1 
1 1 20 1 1 1 1 1 1 1 
1 1 1 1 1 1 1 1 1 1 
1 1 1 1 1 1 21 1 1 1 
20 20 20 20 1 1 1 1 1 1 
1 1 1 1 1 1 1 1 1 1 
1 1 1 1 23 23 1 1 1 1 
1 1 1 1 23 23 1 1 1 1 
1 1 1 1 20 20 1 1 1 1 
1 1 1 1 20 20 1 1 1 1 