30
30
9 10 27 28 29 30 31 32 27 28 29 30 31 32 30 30 30 30 30 30 30 30 30 30 30 30 30 30 30 30 
18 19 36 37 38 39 40 41 36 37 38 39 40 41 30 30 30 30 30 30 30 30 30 30 30 30 30 30 30 30 
11 48 49 30 30 30 30 30 30 30 30 30 30 30 30 30 30 30 30 30 30 30 30 30 30 30 30 30 30 30 
20 57 58 30 30 30 30 30 30 30 30 30 30 30 30 30 30 30 30 30 30 30 30 30 30 30 30 30 30 30 
29 48 49 30 30 30 30 30 30 30 30 30 30 30 30 30 30 30 30 30 30 30 30 30 30 30 30 30 30 30 
38 57 58 30 30 30 30 30 30 30 30 30 30 30 30 30 30 30 30 30 30 30 30 30 30 30 30 30 30 30 
47 48 49 30 30 30 30 30 30 30 30 30 30 30 30 30 30 30 30 30 30 30 30 30 30 30 30 30 30 30 
56 57 58 30 30 30 30 30 30 30 30 30 30 30 30 30 30 30 30 30 30 30 30 21 21 21 21 30 30 30 
65 30 30 30 30 30 30 30 30 30 21 30 30 30 30 30 30 30 30 21 21 21 21 30 30 30 21 30 30 30 
74 30 30 30 30 30 30 30 30 30 21 30 30 30 30 30 30 30 30 21 30 30 30 30 30 30 21 30 30 30 
11 30 30 30 30 30 30 30 30 30 21 30 30 30 30 30 30 30 30 21 30 30 30 30 30 30 21 30 30 30 
20 30 30 30 30 30 30 30 30 30 21 30 30 30 30 30 30 30 30 21 30 30 30 30 30 30 21 30 30 30 
29 30 30 30 30 30 30 30 30 30 21 30 30 30 30 30 30 30 30 21 30 30 30 30 30 30 30 21 30 30 
38 30 30 30 30 30 30 30 30 30 21 30 30 30 30 30 30 30 30 21 30 30 30 30 30 30 30 21 30 30 
47 30 30 30 30 30 30 30 30 30 21 30 30 30 30 30 30 30 30 21 30 30 30 30 30 30 30 21 21 30 
56 30 30 30 30 30 30 30 30 30 21 30 30 30 30 30 30 30 30 21 30 30 30 30 30 30 30 30 30 30 
65 30 30 30 30 30 30 30 30 30 21 30 30 30 30 30 30 30 30 21 30 30 30 30 30 30 30 30 30 30 
74 30 30 30 30 30 30 30 30 30 21 30 30 30 30 30 30 30 30 21 30 30 30 30 30 30 30 30 30 30 
11 30 30 30 30 30 30 30 30 30 21 21 21 21 21 21 21 21 21 21 21 30 30 30 30 30 30 30 30 30 
20 30 30 30 30 30 30 30 30 30 30 30 30 30 30 30 30 30 30 30 30 30 30 30 30 30 30 30 30 30 
29 30 30 30 30 30 30 30 30 30 30 30 30 30 30 30 30 30 30 30 30 30 30 30 30 30 30 30 30 30 
38 30 30 30 30 30 30 30 30 30 30 30 30 30 30 30 30 30 30 30 30 30 30 30 30 30 30 30 30 30 
47 30 30 30 30 30 30 30 30 30 30 30 30 30 30 30 30 30 30 30 30 30 30 30 30 30 30 30 30 30 
56 30 30 30 30 30 30 30 30 30 30 30 30 30 30 30 30 30 30 30 30 30 30 30 30 30 30 30 30 30 
65 30 30 30 30 30 30 30 30 30 30 30 30 30 30 30 30 30 30 30 30 30 30 30 30 30 30 30 30 30 
74 30 30 30 30 30 30 30 30 30 30 30 30 30 30 30 30 30 30 30 30 30 30 30 30 30 30 30 30 30 
48 49 48 49 66 66 66 66 66 66 66 66 66 66 66 67 13 14 13 14 13 14 13 14 30 30 30 30 30 30 
57 58 57 58 75 75 75 75 75 75 75 75 75 75 75 76 22 23 22 23 22 23 22 23 30 30 30 30 30 30 
48 49 48 49 46 47 46 47 46 47 46 47 46 47 46 47 19 20 19 20 19 20 19 20 30 19 20 30 30 30 
57 58 57 58 55 56 55 56 55 56 55 56 55 56 55 56 28 29 28 29 28 29 28 29 30 28 29 30 30 30 